===============================================================
=                                                             =
=                                                             =
=                                                             =
=                                                             =
=                                                             =
=                                                             =
=                                                             =
=                                                             =
=                                                             =
=                                                             =
=                                                             =
=                                                             =
=                                                             =
=                                                             =
=                                                             =
=                                                             =
=                                                             =
=                                                             =
=                                                             =
=                                                             =
=                                                             =
=                                                             =
=                                                             =
=                                                             =
=                                                             =
=                                                             =
=     =                                                       =
=      =                                                      =
=       =                                                     =
=        =           =                                        =
=         =H S      bd                                        =
==========================^====================================