===============================================================
=                                                             =
============================================================= =
=                                                             =
= =============================================================
=                                                             =
============================================================= =
=                                                             =
= =============================================================
=                                                             =
============================================================= =
=                                                             =
= =============================================================
=                                                             =
============================================================= =
=                                                             =
= =============================================================
=                                                             =
============================================================= =
=                                                             =
= =============================================================
=                                                             =
============================================================= =
=      ||                                                     =
= =============================================================
=~    S                                                       =
============================================================= =
=     =                                                       =
=      =                                                      =
=       =  H                                                  =
=        =           =                                        =
=         =         bd                 s                      =
==========================^====================================
